111111111111
111111111111
111111111111
111111111111
111000003111
111001010111
111200200111
111301110111
111000000111
111111111111
111111111111
111111111111